11111111111
10000000001
1000CP00001
100000E0001
11111111001
11111100011
11111111111
