01111111111
10000000001
100000ECP01
11111111111