1111111111
100P000001
100000C001
1111111111